,t,BALANCE,ANNUITY,PRINCIPAL,INTEREST,IRR,EL,PROB
0,0,10000,,,,0.0,1000.0,0.2
1,1,8824.45,3859.79,1175.55,2684.24,-0.61,882.45,0.16
2,2,7333.35,3859.79,1491.1,2368.69,-0.16,733.34,0.13
3,3,5442.0,3859.79,1891.35,1968.44,0.08,544.2,0.1
4,4,3042.97,3859.79,2399.03,1460.76,0.2,304.3,0.08
5,5,-0.01,3859.79,3042.98,816.81,0.26842364652304607,-0.0,0.33
